....#######################
###.############.........##
###.############.#######.##
###.############.#######.##
....############.#######.##
.###############.#######.##
.................#######.##
#####################....##
#####################.#####
#####################......